A,B,C,D,E,F,G
25/03/2020,4,4,0,0,0,0
26/03/2020,5,9,0,0,0,0
27/03/2020,5,14,0,0,1,1
28/03/2020,6,20,0,0,0,1
30/03/2020,7,27,0,0,0,1
31/03/2020,18,45,0,0,0,1
01/04/2020,32,77,0,0,0,1
02/04/2020,2,79,0,0,0,1
03/04/2020,35,114,0,0,0,1
04/04/2020,14,128,0,0,0,1
05/04/2020,7,135,0,0,0,1
06/04/2020,16,151,0,0,0,1