A,B,C,D,E,F,G
12/03/2020,1,1,0,0,0,0
14/03/2020,1,2,0,0,0,0
16/03/2020,2,4,0,0,0,0
19/03/2020,1,5,0,0,0,0
22/03/2020,1,6,0,0,0,0
23/03/2020,2,8,0,0,0,0
24/03/2020,6,14,0,0,0,0
25/03/2020,2,16,0,0,0,0
27/03/2020,2,18,0,0,0,0
28/03/2020,1,19,0,0,0,0
29/03/2020,4,23,0,0,0,0
31/03/2020,13,36,0,0,0,0
02/04/2020,9,45,0,0,0,0
03/04/2020,10,55,0,0,0,0
04/04/2020,22,77,0,0,0,0
05/04/2020,5,82,0,0,0,0
06/04/2020,3,85,0,0,0,0
07/04/2020,2,87,0,0,0,0